[MAP]
64 64
1111111111111111111111111111111111111111111111111111111111111110
1727172727272717272727172717172717272717271727172727271727272710
1212121212121211121212121212121212111112111212121211111211111210
1717172727172727271717172727271727271727172717171717271727172710
1212111112121112111112121212121111121211111212111212121112111210
1727271717172717271717272717172717272727272717272717172717271710
1211121212111112111222111111111211121112111111111112111211111210
1727172727172727172717272727172717271717272717172727172717272710
1212121211121211121111111212121111121211121112121111111212111210
1717172717271717271727171717272727272727171727271727171727171710
1212111111121111121211121212121111121211121112121212121112121110
1727272727271727271717272717171727171717271727171717272717272710
1211111112111211111211121212121211121112111112111112111211121110
1727271727172727272727171717171727271717272727271727172717271710
1112111212111212111111121212121111111211111111111112111212111210
1717172717271727171727271717172727171717171717171727172727272710
1212121111121112121212121212121112121212121212121211111111121110
1727171727272727271717272717171717271727272727272717272717271710
1211121211121211121211111111121211121211121211121112111212111210
1727271727171717172717171727272717272717271727172727172727271710
1111111112111212121112121212121111111112121112121111111211111210
1717272727172717171727272717171717171727171727171727272717172710
1212121111121112121111121112111212121211121111121212111112121110
1727171727171727271727271717172717272717272727271717272727171710
1111121211121112111211111212121212121112111111121211121112121210
1727271727172717272717272727171727171727172727271727171727272710
1212121211111212111211121111111211121112111112111211121111111210
1717172717272717271717271727171717271727271727272727172727271710
1212121211111211121211121112121611111111121112121111111211121210
1717171717271727271727171727276667172727171727171727272727171710
1212111212121111111112121112111611121211121111121112111111121110
1717271727172727172717271727172717171727172777171727172727272710
1111111111121211121211111112111212121211111112121212121111111210
1727172727171717271727272727271727271727272727271717171727272710
1112111212121211121212111112111211111111111112111212121111121210
1727271717271727271717171717172717172717272727272717172717271710
1111121212121211111112121211121212121212111111111112111211121110
1727172717172727171717271727272717271717172727172727272727271710
1112112112111112121211121211111111121212121112111111121212111210
1727172727172717272717271727171727271727171717272727171717272710
1112121111121211111112111112121211121211121211121112111211111210
1727271727271717172727171727272717272717171727172717271727172710
1211111111111212121111121211121211111112121211111211121212121210
1727272727272717271727171727171727271717272727271717171717171710
1111111112111212111212121112111111121212111211121212121212121110
1727272717171717172717271717272727172717171717171717271717272710
1211111212121112121211111212111211111212121212121112111111121210
1727271727172727271727271727171717271727171717172727271727271710
1112111111121111111212111211121212121111121212111211121211111210
1727172727271717271717171717271717172717172727172717271717172710
1111121112111212121211121211121111121211111111111212111212121210
1727171727172727171727272717272727171717272717171717271727271710
1212111212111211121112111111111112121112111212121211121112121110
1717271717271727171717172727272727172727171717272717172727272710
1211121212121111121212111211111211111111121211121212121111111210
1717171717172717271717272717271717272727271727272717271717272710
1112121112111212111211121112121211111211121112121111111211121210
1727272717271717272717171717171727271717272727171727272717271710
1112111211111212111212111212121111121112121211111211111212111210
1727171717272717272727272727171727172727171717172717171717172710
1112121212111112111212111212121212121111121212121212121112121210
1727172727272727172717172717172717271727271727271717272727271710
1111111111111111111111111111111111111111111111111111111111111110
0000000000000000000000000000000000000000000000000000000000000000
[PLAYER]
%player = X Y
player = 1 1
[EXITS]
%exit = X Y MAP_NAME MAP_X MAP_Y
exit = 29 31 END 0 0
[DOORS]
%door = X Y ID UNLOCKED
door = 28 31 1 0
door = 29 30 2 0
door = 29 32 3 0
door = 30 31 4 0
[KEYS]
%key = X Y ID
key = 17 37 4
key = 31 43 3
key = 53 23 2
key = 57 57 1
[PERSONS]
%person = X Y NAME DIALOG_ID
person = 1 3 Steven 0
person = 1 61 Amethyst 1
person = 61 1 Pearl 2
person = 61 61 Garnet 3
[DIALOGS]
%dialog = ID TEXT
dialog = 0 You need any of the four keys to exit this maze.
dialog = 1 GET ME OUT OF HERE!
dialog = 2 Now where is Steven? I told him this place was dangerous!
dialog = 3 Each key works on one door only.
